^^^^^^^^^^^^^^^^^^^^^^^^^^^^
^    ^^^                   ^
^     ^                    ^
^        ~            *    ^
^       ~~~          ***   ^
^       ~~~     ^^    *    ^
^        ~      ^^^        ^
^               ^^^^       ^
^    ^                     ^
^   *^^       *     ~~     ^
^   *^^      **    ~~~     ^
^   ^^^^    ***    ~~      ^
^     ^^     *     ~~      ^
^                          ^
^^^^^^^^^^^^^^^^^^^^^^^^^^^^