+---------------------+----------+------------------------+-----------+-------------------------+
|                     |          |                        |           |                         |
|                     +----------+                        |           |                         |
|                                                         |           |                         |
|                     +----------+                        |           |                         |
|                     |          |                        |           |                         |
+---------+ +---------+          |                        +-----------+                         |
|         | |                    |                                                              |
|         | |                    |                        +----+ +----+----------+ +------------+
|         | |                    |                        |    | |               | |            |
|         | |                    +---------------+ +------+    | |    +----------+ +------------+
|         | |                                    | |           | |    |                         |
|    +----+ +-------------------+                | |           | |    |                         |
|    |                          |         +------+ +------+    | |    |                         |
|    |                          |         |               |    | |    |                         |
|    |                          +---------+               +----+ +----+                         |
|    |                                                                                          |
|    |                          +---------+               +-----------+                         |
|    |                          |         |               |           |                         |
|    |                          |         +---------------+           |                         |
|    |                          |                                     |                         |
+----+--------------------------+-------------------------------------+-------------------------+