+--------------------------+
|    ^^^                   |
|     ^                    |
|        ~            *    |
|       ~~~          ***   |
|       ~~~     ^^    *    |
|        ~      ^^^        |
|               ^^^^       |
|    ^                     |
|   *^^             ~~     |
|   *^^            ~~~     |
|   ^^^^      *    ~~      |
|     ^^     **    ~~      |
|           ***            |
+--------------------------+